KGA = "conutries/Kuromorimine.txt"
BCF = "conutries/BCFreedom.txt"
BON = "countries/Bonple.txt"
ANZ = "countries/Anzio.txt"
PRA = "countries/Pravda.txt"
SDS = "countries/Saunders.txt"
STG = "countries/StGloriana.txt"
CHT = "countries/ChiHaTan.txt"
JHS = "countries/Jatkosota.txt"
BDH = "countries/BlueDivision.txt"
ASU = "countries/AllStar.txt"
COU = "countries/Count.txt"
GHS = "countries/Gregor.txt"
KFA = "countries/KoalaForest.txt"
MAP = "countries/Maple.txt"
THS = "countries/Tategoto.txt"
VIG = "countries/Viggen.txt"
VIK = "countries/VikingFisheries.txt"
WAF = "countries/Waffle.txt"
YOG = "countries/Yogurt.txt"
KEB = "countries/Kebab.txt"
BKC = "countries/BonpleKuromorimineComplexity.txt"
MGC = "countries/Maginot.txt"
GBT = "countries/Gilbert.txt"

ORA = "countries/OoariRabbit.txt"
ODU = "countries/OoariDuck.txt"
OHI = "countries/OoariHippo.txt"
OTU = "countries/OoariTurtle.txt"
OML = "countries/OoariMallard.txt"
OAN = "countries/OoariAnteater.txt"
OLE = "countries/OoariLeopon.txt"
OSH = "countries/OoariShark.txt"